"filename", "language", "Markdown", "C++", "PowerShell", "comment", "blank", "total"
"d:\DataBaseProject\2023-BJTU-DBMS-Project\README.md", "Markdown", 239, 0, 0, 0, 93, 332
"d:\DataBaseProject\2023-BJTU-DBMS-Project\cmd\Build.ps1", "PowerShell", 0, 0, 5, 2, 0, 7
"d:\DataBaseProject\2023-BJTU-DBMS-Project\cmd\README.md", "Markdown", 3, 0, 0, 0, 1, 4
"d:\DataBaseProject\2023-BJTU-DBMS-Project\cmd\include\command_processor.h", "C++", 0, 26, 0, 2, 11, 39
"d:\DataBaseProject\2023-BJTU-DBMS-Project\cmd\include\header_template.h", "C++", 0, 5, 0, 0, 7, 12
"d:\DataBaseProject\2023-BJTU-DBMS-Project\cmd\include\my_parser.h", "C++", 0, 49, 0, 8, 16, 73
"d:\DataBaseProject\2023-BJTU-DBMS-Project\cmd\src\command_processor.cpp", "C++", 0, 72, 0, 13, 32, 117
"d:\DataBaseProject\2023-BJTU-DBMS-Project\cmd\src\my_parser.cpp", "C++", 0, 266, 0, 38, 119, 423
"d:\DataBaseProject\2023-BJTU-DBMS-Project\cmd\test\main.cpp", "C++", 0, 11, 0, 0, 5, 16
"d:\DataBaseProject\2023-BJTU-DBMS-Project\cmd\test\测试语句.md", "Markdown", 40, 0, 0, 0, 11, 51
"d:\DataBaseProject\2023-BJTU-DBMS-Project\core\README.md", "Markdown", 91, 0, 0, 0, 21, 112
"d:\DataBaseProject\2023-BJTU-DBMS-Project\core\include\colasqltool.h", "C++", 0, 26, 0, 9, 15, 50
"d:\DataBaseProject\2023-BJTU-DBMS-Project\core\include\constants.h", "C++", 0, 32, 0, 0, 5, 37
"d:\DataBaseProject\2023-BJTU-DBMS-Project\core\include\constraint\all_constraints.h", "C++", 0, 6, 0, 1, 3, 10
"d:\DataBaseProject\2023-BJTU-DBMS-Project\core\include\constraint\constraint.h", "C++", 0, 13, 0, 0, 9, 22
"d:\DataBaseProject\2023-BJTU-DBMS-Project\core\include\constraint\default_constraint.h", "C++", 0, 14, 0, 1, 9, 24
"d:\DataBaseProject\2023-BJTU-DBMS-Project\core\include\constraint\foreign_key_constraint.h", "C++", 0, 17, 0, 1, 11, 29
"d:\DataBaseProject\2023-BJTU-DBMS-Project\core\include\constraint\not_null_constraint.h", "C++", 0, 9, 0, 1, 4, 14
"d:\DataBaseProject\2023-BJTU-DBMS-Project\core\include\constraint\primary_key_constraint.h", "C++", 0, 9, 0, 1, 4, 14
"d:\DataBaseProject\2023-BJTU-DBMS-Project\core\include\constraint\unique_constraint.h", "C++", 0, 9, 0, 1, 4, 14
"d:\DataBaseProject\2023-BJTU-DBMS-Project\core\include\database.h", "C++", 0, 32, 0, 0, 9, 41
"d:\DataBaseProject\2023-BJTU-DBMS-Project\core\include\dataprocessor.h", "C++", 0, 48, 0, 7, 10, 65
"d:\DataBaseProject\2023-BJTU-DBMS-Project\core\include\table.h", "C++", 0, 40, 0, 7, 8, 55
"d:\DataBaseProject\2023-BJTU-DBMS-Project\core\include\user.h", "C++", 0, 18, 0, 2, 6, 26
"d:\DataBaseProject\2023-BJTU-DBMS-Project\core\main.cpp", "C++", 0, 77, 0, 16, 19, 112
"d:\DataBaseProject\2023-BJTU-DBMS-Project\core\src\colasqltool.cpp", "C++", 0, 211, 0, 2, 31, 244
"d:\DataBaseProject\2023-BJTU-DBMS-Project\core\src\constraint\constraint.cpp", "C++", 0, 11, 0, 1, 5, 17
"d:\DataBaseProject\2023-BJTU-DBMS-Project\core\src\constraint\default_constraint.cpp", "C++", 0, 9, 0, 0, 3, 12
"d:\DataBaseProject\2023-BJTU-DBMS-Project\core\src\constraint\foreign_key_constraint.cpp", "C++", 0, 16, 0, 0, 5, 21
"d:\DataBaseProject\2023-BJTU-DBMS-Project\core\src\constraint\not_null_constraint.cpp", "C++", 0, 3, 0, 0, 2, 5
"d:\DataBaseProject\2023-BJTU-DBMS-Project\core\src\constraint\primary_key_constraint.cpp", "C++", 0, 3, 0, 0, 3, 6
"d:\DataBaseProject\2023-BJTU-DBMS-Project\core\src\constraint\unique_constraint.cpp", "C++", 0, 3, 0, 0, 2, 5
"d:\DataBaseProject\2023-BJTU-DBMS-Project\core\src\database.cpp", "C++", 0, 108, 0, 1, 18, 127
"d:\DataBaseProject\2023-BJTU-DBMS-Project\core\src\dataprocessor.cpp", "C++", 0, 233, 0, 2, 30, 265
"d:\DataBaseProject\2023-BJTU-DBMS-Project\core\src\table.cpp", "C++", 0, 264, 0, 33, 23, 320
"d:\DataBaseProject\2023-BJTU-DBMS-Project\core\src\user.cpp", "C++", 0, 14, 0, 0, 5, 19
"d:\DataBaseProject\2023-BJTU-DBMS-Project\file\README.md", "Markdown", 18, 0, 0, 0, 11, 29
"d:\DataBaseProject\2023-BJTU-DBMS-Project\file\include\filemanager.h", "C++", 0, 19, 0, 3, 13, 35
"d:\DataBaseProject\2023-BJTU-DBMS-Project\file\src\filemanager.cpp", "C++", 0, 138, 0, 27, 57, 222
"d:\DataBaseProject\2023-BJTU-DBMS-Project\gui\ColaSqlGui\columndialog.cpp", "C++", 0, 36, 0, 6, 7, 49
"d:\DataBaseProject\2023-BJTU-DBMS-Project\gui\ColaSqlGui\columndialog.h", "C++", 0, 24, 0, 4, 5, 33
"d:\DataBaseProject\2023-BJTU-DBMS-Project\gui\ColaSqlGui\main.cpp", "C++", 0, 7, 0, 1, 3, 11
"d:\DataBaseProject\2023-BJTU-DBMS-Project\gui\ColaSqlGui\mainwindow.cpp", "C++", 0, 217, 0, 19, 20, 256
"d:\DataBaseProject\2023-BJTU-DBMS-Project\gui\ColaSqlGui\mainwindow.h", "C++", 0, 36, 0, 0, 9, 45
"d:\DataBaseProject\2023-BJTU-DBMS-Project\gui\ColaSqlGui\qtbstreambuf.h", "C++", 0, 24, 0, 0, 7, 31
"d:\DataBaseProject\2023-BJTU-DBMS-Project\gui\ColaSqlGui\ui_login.cpp", "C++", 0, 36, 0, 1, 8, 45
"d:\DataBaseProject\2023-BJTU-DBMS-Project\gui\ColaSqlGui\ui_login.h", "C++", 0, 27, 0, 0, 12, 39
"d:\DataBaseProject\2023-BJTU-DBMS-Project\gui\ColaSqlGui\ui_register.cpp", "C++", 0, 39, 0, 2, 7, 48
"d:\DataBaseProject\2023-BJTU-DBMS-Project\gui\ColaSqlGui\ui_register.h", "C++", 0, 26, 0, 0, 12, 38
"d:\DataBaseProject\2023-BJTU-DBMS-Project\gui\README.md", "Markdown", 3, 0, 0, 0, 1, 4
"Total", "-", 394, 2283, 5, 212, 731, 3625